track_name	track_type	TCGA-DJ-A3UN	TCGA-FY-A3I5	TCGA-ET-A3BV	TCGA-EL-A3H5	TCGA-DJ-A2Q1	TCGA-EL-A3MY	TCGA-EL-A3T9	TCGA-DJ-A13W	TCGA-EL-A3GP	TCGA-EM-A4FM	TCGA-EL-A3CY	TCGA-EL-A3CV	TCGA-DJ-A3VF	TCGA-EL-A4K4	TCGA-BJ-A18Z	TCGA-DJ-A3VD	TCGA-EL-A3ZO	TCGA-FE-A3PB	TCGA-KS-A41L	TCGA-EM-A3FN	TCGA-FY-A4B3	TCGA-EM-A1YD	TCGA-EM-A1YE	TCGA-FE-A235	TCGA-EM-A3AI	TCGA-EM-A4FH	TCGA-EL-A3CO	TCGA-BJ-A0ZG	TCGA-EM-A1YC	TCGA-J8-A42S	TCGA-4C-A93U	TCGA-DE-A3KN	TCGA-BJ-A0ZC	TCGA-BJ-A28Z	TCGA-EL-A3ZS	TCGA-EM-A3O3	TCGA-CE-A484	TCGA-EL-A3ZR	TCGA-EM-A4FU	TCGA-FY-A3R6	TCGA-BJ-A3F0	TCGA-MK-A4N7	TCGA-DJ-A1QI	TCGA-EM-A3O7	TCGA-DJ-A2PV	TCGA-BJ-A0Z0	TCGA-ET-A2MZ	TCGA-EM-A22L	TCGA-FY-A3R9	TCGA-DJ-A13X	TCGA-FK-A3SB	TCGA-EL-A3CL	TCGA-ET-A40P	TCGA-DJ-A2Q7	TCGA-DJ-A3UK	TCGA-DJ-A3VM	TCGA-EL-A3GQ	TCGA-EM-A1CS	TCGA-EM-A1YA	TCGA-EM-A22K	TCGA-BJ-A0Z3	TCGA-EL-A3CP	TCGA-ET-A3DQ	TCGA-DE-A69J	TCGA-EM-A1CV	TCGA-ET-A39O	TCGA-MK-A4N6	TCGA-DJ-A1QN	TCGA-EL-A3CX	TCGA-ET-A3DP	TCGA-ET-A25O	TCGA-EM-A3ST	TCGA-KS-A4I1	TCGA-DJ-A13R	TCGA-FE-A22Z	TCGA-DJ-A2Q3	TCGA-FK-A3SG	TCGA-IM-A3U2	TCGA-DJ-A3V3	TCGA-IM-A3EB	TCGA-EM-A22J	TCGA-EM-A22M	TCGA-EL-A3GO	TCGA-FY-A3I4	TCGA-DJ-A2Q9	TCGA-BJ-A45E	TCGA-DJ-A1QL	TCGA-EM-A3AL	TCGA-BJ-A45K	TCGA-EM-A3SX	TCGA-CE-A485	TCGA-H2-A3RH	TCGA-DJ-A4UT	TCGA-EM-A22P	TCGA-EL-A3T0	TCGA-EL-A4KD	TCGA-ET-A39L	TCGA-FY-A76V	TCGA-EL-A4K9	TCGA-EL-A4K6	TCGA-ET-A3BX	TCGA-ET-A3BN	TCGA-DE-A4M9	TCGA-EL-A3D6	TCGA-ET-A39N	TCGA-FY-A2QD	TCGA-EL-A3CT	TCGA-BJ-A0YZ	TCGA-EL-A3H4	TCGA-EM-A2CQ	TCGA-EM-A3AR	TCGA-EM-A3FL	TCGA-EM-A3OA	TCGA-ET-A4KN	TCGA-BJ-A45D	TCGA-EL-A3D1	TCGA-ET-A3BP	TCGA-KS-A41F	TCGA-BJ-A2P4	TCGA-EL-A3ZQ	TCGA-EL-A4KH	TCGA-ET-A39M	TCGA-FK-A3SH	TCGA-DJ-A1QQ	TCGA-EM-A3FK	TCGA-IM-A3ED	TCGA-DE-A2OL	TCGA-FY-A3ON	TCGA-DE-A0XZ	TCGA-DJ-A2PW	TCGA-DJ-A3VE	TCGA-EL-A3GR	TCGA-EL-A3GS	TCGA-EL-A3T8	TCGA-EM-A2OY	TCGA-EL-A3H2	TCGA-FY-A3WA	TCGA-ET-A3DS	TCGA-EM-A2CP	TCGA-BJ-A191	TCGA-EL-A3T2	TCGA-EM-A2CL	TCGA-J8-A3O1	TCGA-EM-A3SY	TCGA-DJ-A2Q0	TCGA-EM-A22Q	TCGA-ET-A2N0	TCGA-EM-A3AO	TCGA-EL-A3D4	TCGA-EM-A2P2	TCGA-E8-A438	TCGA-FE-A3PA	TCGA-CE-A13K	TCGA-DE-A69K	TCGA-EL-A3H3	TCGA-EM-A2CJ	TCGA-EM-A3FO	TCGA-FK-A3S3	TCGA-EM-A3OB	TCGA-EM-A1YB	TCGA-EL-A3MX	TCGA-ET-A3DT	TCGA-BJ-A0Z9	TCGA-BJ-A192	TCGA-BJ-A290	TCGA-DO-A1JZ	TCGA-EL-A3GZ	TCGA-EL-A4KI	TCGA-IM-A41Y	TCGA-BJ-A28V	TCGA-BJ-A2N9	TCGA-FY-A3NM	TCGA-DJ-A2Q4	TCGA-EM-A1CU	TCGA-ET-A25G	TCGA-ET-A25K	TCGA-J8-A4HW	TCGA-E8-A432	TCGA-H2-A2K9	TCGA-EM-A4G1	TCGA-EM-A3O6	TCGA-FK-A3SD	TCGA-BJ-A0ZH	TCGA-DJ-A2QC	TCGA-ET-A2N4	TCGA-J8-A3YE	TCGA-EL-A4JZ	TCGA-ET-A39S	TCGA-ET-A3DV	TCGA-EL-A3H1	TCGA-EM-A2OW	TCGA-EM-A2OV	TCGA-EM-A3FR	TCGA-BJ-A4O8	TCGA-FY-A3TY	TCGA-E8-A413	TCGA-EL-A4K0	TCGA-E8-A418	TCGA-ET-A2N3	TCGA-J8-A3YG	TCGA-BJ-A3PR	TCGA-BJ-A3EZ	TCGA-DJ-A1QG	TCGA-DJ-A13S	TCGA-DO-A1K0	TCGA-EL-A3T1	TCGA-KS-A4IB	TCGA-DJ-A3VJ	TCGA-FY-A4B4	TCGA-DE-A4MB	TCGA-BJ-A4O9	TCGA-DJ-A4UR	TCGA-EM-A3FP	TCGA-EM-A4FR	TCGA-FK-A4UB	TCGA-CE-A482	TCGA-DJ-A4V5	TCGA-EM-A2CU	TCGA-EM-A3AQ	TCGA-EM-A3FQ	TCGA-ET-A39K	TCGA-FY-A40M	TCGA-BJ-A28T	TCGA-BJ-A28X	TCGA-DE-A4M8	TCGA-DO-A2HM	TCGA-EM-A2P1	TCGA-EM-A3AJ	TCGA-EM-A4FO	TCGA-H2-A26U	TCGA-EM-A22I	TCGA-DJ-A1QF	TCGA-DJ-A2PQ	TCGA-DJ-A2PU	TCGA-E3-A3DY	TCGA-EL-A3CU	TCGA-EL-A3GV	TCGA-EL-A3GY	TCGA-EM-A3AK	TCGA-EM-A3FJ	TCGA-ET-A3BQ	TCGA-FY-A3NN	TCGA-FY-A40K	TCGA-DJ-A2Q6	TCGA-DJ-A4UW	TCGA-EM-A3AP	TCGA-MK-A4N9	TCGA-DJ-A2PT	TCGA-DJ-A3VB	TCGA-DJ-A13M	TCGA-EL-A3T3	TCGA-EL-A3ZH	TCGA-EL-A3ZK	TCGA-EL-A4JW	TCGA-ET-A3BU	TCGA-FK-A3SE	TCGA-KS-A4I5	TCGA-BJ-A0Z2	TCGA-BJ-A0ZA	TCGA-BJ-A0ZB	TCGA-BJ-A0ZE	TCGA-BJ-A0ZJ	TCGA-BJ-A2N7	TCGA-BJ-A2N8	TCGA-BJ-A2NA	TCGA-BJ-A3PT	TCGA-BJ-A3PU	TCGA-BJ-A18Y	TCGA-BJ-A28R	TCGA-BJ-A28S	TCGA-BJ-A45F	TCGA-BJ-A45G	TCGA-BJ-A45H	TCGA-BJ-A45I	TCGA-BJ-A45J	TCGA-CE-A3MD	TCGA-CE-A3ME	TCGA-CE-A27D	TCGA-CE-A481	TCGA-CE-A483	TCGA-DE-A0Y2	TCGA-DE-A0Y3	TCGA-DE-A4MA	TCGA-DE-A4MC	TCGA-DE-A4MD	TCGA-DE-A7U5	TCGA-DJ-A1QD	TCGA-DJ-A1QE	TCGA-DJ-A1QH	TCGA-DJ-A1QM	TCGA-DJ-A1QO	TCGA-DJ-A2PN	TCGA-DJ-A2PO	TCGA-DJ-A2PP	TCGA-DJ-A2PR	TCGA-DJ-A2PS	TCGA-DJ-A2PX	TCGA-DJ-A2PY	TCGA-DJ-A2PZ	TCGA-DJ-A2Q2	TCGA-DJ-A2Q5	TCGA-DJ-A2QA	TCGA-DJ-A2QB	TCGA-DJ-A3UM	TCGA-DJ-A3UO	TCGA-DJ-A3UP	TCGA-DJ-A3UQ	TCGA-DJ-A3UR	TCGA-DJ-A3US	TCGA-DJ-A3UT	TCGA-DJ-A3UU	TCGA-DJ-A3UW	TCGA-DJ-A3UX	TCGA-DJ-A3UY	TCGA-DJ-A3UZ	TCGA-DJ-A3V0	TCGA-DJ-A3V2	TCGA-DJ-A3V4	TCGA-DJ-A3V5	TCGA-DJ-A3V7	TCGA-DJ-A3V8	TCGA-DJ-A3V9	TCGA-DJ-A3VA	TCGA-DJ-A3VG	TCGA-DJ-A3VI	TCGA-DJ-A3VK	TCGA-DJ-A3VL	TCGA-DJ-A4UL	TCGA-DJ-A4UP	TCGA-DJ-A4UQ	TCGA-DJ-A4V0	TCGA-DJ-A4V2	TCGA-DJ-A4V4	TCGA-DJ-A13L	TCGA-DJ-A13O	TCGA-DJ-A13P	TCGA-DJ-A13T	TCGA-DJ-A13U	TCGA-DJ-A13V	TCGA-E3-A3DZ	TCGA-E3-A3E0	TCGA-E3-A3E1	TCGA-E3-A3E2	TCGA-E3-A3E3	TCGA-E3-A3E5	TCGA-E8-A2EA	TCGA-E8-A3X7	TCGA-E8-A44K	TCGA-E8-A44M	TCGA-E8-A242	TCGA-E8-A414	TCGA-E8-A415	TCGA-E8-A416	TCGA-E8-A417	TCGA-E8-A419	TCGA-E8-A433	TCGA-E8-A434	TCGA-E8-A436	TCGA-E8-A437	TCGA-EL-A3CM	TCGA-EL-A3CN	TCGA-EL-A3CR	TCGA-EL-A3CS	TCGA-EL-A3CW	TCGA-EL-A3CZ	TCGA-EL-A3GU	TCGA-EL-A3GW	TCGA-EL-A3GX	TCGA-EL-A3H7	TCGA-EL-A3H8	TCGA-EL-A3MW	TCGA-EL-A3MZ	TCGA-EL-A3N2	TCGA-EL-A3N3	TCGA-EL-A3T6	TCGA-EL-A3T7	TCGA-EL-A3TA	TCGA-EL-A3TB	TCGA-EL-A3ZG	TCGA-EL-A3ZL	TCGA-EL-A3ZN	TCGA-EL-A3ZP	TCGA-EL-A3ZT	TCGA-EL-A4JV	TCGA-EL-A4JX	TCGA-EL-A4K1	TCGA-EL-A4K2	TCGA-EL-A4K7	TCGA-EL-A4KG	TCGA-EM-A1CT	TCGA-EM-A1CW	TCGA-EM-A2CK	TCGA-EM-A2CN	TCGA-EM-A2CO	TCGA-EM-A2CT	TCGA-EM-A2OX	TCGA-EM-A2OZ	TCGA-EM-A2P0	TCGA-EM-A2P3	TCGA-EM-A3AN	TCGA-EM-A3FM	TCGA-EM-A3O8	TCGA-EM-A3O9	TCGA-EM-A3SU	TCGA-EM-A3SZ	TCGA-EM-A4FF	TCGA-EM-A4FK	TCGA-EM-A4FN	TCGA-EM-A4FQ	TCGA-EM-A4FV	TCGA-EM-A22N	TCGA-EM-A22O	TCGA-ET-A2MX	TCGA-ET-A2MY	TCGA-ET-A2N5	TCGA-ET-A3BO	TCGA-ET-A3BS	TCGA-ET-A3BT	TCGA-ET-A3BW	TCGA-ET-A3DO	TCGA-ET-A3DR	TCGA-ET-A3DU	TCGA-ET-A3DW	TCGA-ET-A4KQ	TCGA-ET-A25I	TCGA-ET-A25J	TCGA-ET-A25R	TCGA-ET-A39I	TCGA-ET-A39J	TCGA-ET-A39P	TCGA-ET-A39R	TCGA-ET-A39T	TCGA-ET-A40Q	TCGA-ET-A40S	TCGA-ET-A40T	TCGA-FE-A3PC	TCGA-FE-A3PD	TCGA-FE-A23A	TCGA-FE-A230	TCGA-FE-A231	TCGA-FE-A232	TCGA-FE-A233	TCGA-FE-A234	TCGA-FE-A236	TCGA-FE-A237	TCGA-FY-A3BL	TCGA-FY-A3R7	TCGA-FY-A3R8	TCGA-FY-A3RA	TCGA-FY-A3W9	TCGA-FY-A3YR	TCGA-FY-A40L	TCGA-FY-A40N	TCGA-GE-A2C6	TCGA-H2-A3RI	TCGA-H2-A421	TCGA-H2-A422	TCGA-IM-A3U3	TCGA-IM-A4EB	TCGA-IM-A420	TCGA-J8-A3NZ	TCGA-J8-A3O0	TCGA-J8-A3O2	TCGA-J8-A3YD	TCGA-J8-A3YF	TCGA-J8-A3YH	TCGA-J8-A4HY	TCGA-KS-A4I3	TCGA-KS-A4I7	TCGA-KS-A4I9	TCGA-KS-A4IC	TCGA-KS-A4ID	TCGA-KS-A41I	TCGA-KS-A41J	TCGA-L6-A4EP	TCGA-L6-A4EQ	TCGA-L6-A4ET	TCGA-L6-A4EU	TCGA-MK-A84Z	TCGA-QD-A8IV
TWIST1	CNA																																																																																																																																																																																																																																																																																																																																																																																																																																																																																																
SNAI1	CNA																																																																																																																																																																																																																																																																																																																																																																																																																																																																																																
MIR-200A/200A	CNA																															Deep Deletion																																																																																																																																																																																																																																																																																																																																																																																																																																																																	
DKK1	CNA																																Deep Deletion	Deep Deletion	Deep Deletion	Deep Deletion																																																																																																																																																																																																																																																																																																																																																																																																																																																													
CDH2	CNA																																																																																																																																																																																																																																																																																																																																																																																																																																																																																																
CTNNB1	CNA																																																																																																																																																																																																																																																																																																																																																																																																																																																																																																
NOTCH1	CNA																																																																											Amplification	Amplification	Deep Deletion	Deep Deletion	Deep Deletion	Deep Deletion																																																																																																																																																																																																																																																																																																																																																																																																																
SMAD2	CNA																																																																																																																																																																																																																																																																																																																																																																																																																																																																																																
SMAD3	CNA																																																																																																																																																																																																																																																																																																																																																																																																																																																																																																
SMAD4	CNA																																																																																																																																																																																																																																																																																																																																																																																																																																																																																																
VIM	CNA																																																																																																																																																																																																																																																																																																																																																																																																																																																																																																
TP53	CNA																																																																																																																																																															Deep Deletion																																																																																																																																																																																																																																																																																																																																	
CDH1	CNA																																																																																																																																																																	Deep Deletion																																																																																																																																																																																																																																																																																																																															
MAPK3	CNA																																																																																																																																																																																																																																																																																																																																																																																																																																																																																																
AKT2	CNA																																																																																																																																																																																																																																																																																																																																																																																																																																																																																																
MIR-203/203A	CNA																																																																																																																																																																																																																																																																																																																																																																																																																																																																																																
MIR-34/34A	CNA																																																																																																																																																																																																																																																																																																																																																																																																																																																																																																
SNAI2	CNA																																																																																																																																																																																																																																																																																																																																																																																																																																																																																																
TP73	CNA																															Deep Deletion																																																																																																																																																																																																																																																																																																																																																																																																																																																																	
AKT1	CNA																																																																																																																																																																																																																																																																																																																																																																																																																																																																																																
TP63	CNA																																																																																																																																																																																																																																																																																																																																																																																																																																																																																																
ZEB2	CNA																																																																																																																																																																																																																																																																																																																																																																																																																																																																																																
TGFBR1	CNA																																																																													Deep Deletion	Deep Deletion																																																																																																																																																																																																																																																																																																																																																																																																																		
ZEB1	CNA																																																																																																																																																																																																																																																																																																																																																																																																																																																																																																
CDKN1A	CNA																																																																																																																																																																																																																																																																																																																																																																																																																																																																																																
TWIST1	MUTATIONS	Truncating mutation (putative passenger)																																																																																																																																																																																																																																																																																																																																																																																																																																																																																															
SNAI1	MUTATIONS																																																																																																																																																																																																																																																																																																																																																																																																																																																																																																
MIR-200A/200A	MUTATIONS																																																																																																																																																																																																																																																																																																																																																																																																																																																																																																
DKK1	MUTATIONS																																																																																																																																																																																																																																																																																																																																																																																																																																																																																																
CDH2	MUTATIONS																																																																																																																																																																																																																																																																																																																																																																																																																																																																																																
CTNNB1	MUTATIONS																																																													Missense Mutation (putative passenger)																																																																																																																																																																																																																																																																																																																																																																																																																																			
NOTCH1	MUTATIONS																																																																																	Missense Mutation (putative passenger)	Missense Mutation (putative passenger)																																																																																																																																																																																																																																																																																																																																																																																																														
SMAD2	MUTATIONS																																																																																																																																																																																																																																																																																																																																																																																																																																																																																																
SMAD3	MUTATIONS																																																																																																																																																																																																																																																																																																																																																																																																																																																																																																
SMAD4	MUTATIONS																																																																																																																																																																																																																																																																																																																																																																																																																																																																																																
VIM	MUTATIONS																																																																																																																																																																																																																																																																																																																																																																																																																																																																																																
TP53	MUTATIONS																																																																																																								Truncating mutation (putative driver)																																																								Truncating mutation (putative driver)																																																																																																																																																																																																																																																																																																																																
CDH1	MUTATIONS																																																																																																																																																																																																																																																																																																																																																																																																																																																																																																
MAPK3	MUTATIONS																																																																																																																																																																																																																																																																																																																																																																																																																																																																																																
AKT2	MUTATIONS																																																																																																																																																																																											Missense Mutation (putative driver)	Missense Mutation (putative passenger)																																																																																																																																																																																																																																																																																																				
MIR-203/203A	MUTATIONS																																																																																																																																																																																																																																																																																																																																																																																																																																																																																																
MIR-34/34A	MUTATIONS																																																																																																																																																																																																																																																																																																																																																																																																																																																																																																
SNAI2	MUTATIONS																																																																																																																																																																																																	Missense Mutation (putative passenger)																																																																																																																																																																																																																																																																																															
TP73	MUTATIONS																																																																																																											Missense Mutation (putative passenger)																																																																																		Missense Mutation (putative passenger)																																																																																																																																																																																																																																																																																																			
AKT1	MUTATIONS																																																																																																																																																																																																						Missense Mutation (putative driver)										Missense Mutation (putative driver)	Missense Mutation (putative driver)	Missense Mutation (putative driver)	Missense Mutation (putative passenger)																																																																																																																																																																																																																																																																													
TP63	MUTATIONS																																																																																																																																																																																																																																																																																																																																																																																																																																																																																																
ZEB2	MUTATIONS																																																																																																																																																Missense Mutation (putative passenger)																																																																																																																																																																																																																																																																																																																																																
TGFBR1	MUTATIONS																																																																																																																																																																																																																																																																																																																																																																																																																																																																																																
ZEB1	MUTATIONS																																																																																																																																																																																																																																																																																																																																																																																																																																																																																																
CDKN1A	MUTATIONS																																																																																																																		Missense Mutation (putative passenger)																																																																																																																																					Truncating mutation (putative driver)																																																																																																																																																																																																																																									
TWIST1	MRNA		mRNA High	mRNA High	mRNA High	mRNA High	mRNA High	mRNA High	mRNA High	mRNA High	mRNA High	mRNA High	mRNA High	mRNA High	mRNA High	mRNA High	mRNA High	mRNA High	mRNA High																																																																																																																																																																																																																																																																																																																																																																																																																																																																														
SNAI1	MRNA		mRNA High																	mRNA High	mRNA High	mRNA High	mRNA High	mRNA High	mRNA High	mRNA High	mRNA High	mRNA High	mRNA High	mRNA High	mRNA High																																																																																																																																																																																																																																																																																																																																																																																																																																																																		
MIR-200A/200A	MRNA																																																																																																																																																																																																																																																																																																																																																																																																																																																																																																
DKK1	MRNA																																mRNA High				mRNA High	mRNA High	mRNA High	mRNA High	mRNA High																																																																																																																																																																																																																																																																																																																																																																																																																																																								
CDH2	MRNA																																									mRNA High	mRNA High	mRNA High	mRNA High	mRNA High	mRNA High	mRNA High	mRNA High	mRNA High	mRNA High	mRNA High	mRNA High	mRNA High	mRNA High	mRNA High	mRNA High	mRNA High	mRNA High	mRNA High	mRNA High																																																																																																																																																																																																																																																																																																																																																																																																																																				
CTNNB1	MRNA																			mRNA Low	mRNA Low																																										mRNA High	mRNA High	mRNA High	mRNA High	mRNA High	mRNA High	mRNA High	mRNA High	mRNA High	mRNA High	mRNA Low	mRNA Low	mRNA Low																																																																																																																																																																																																																																																																																																																																																																																																																						
NOTCH1	MRNA			mRNA High																		mRNA High	mRNA High																			mRNA High																																										mRNA High	mRNA High	mRNA High	mRNA High	mRNA High	mRNA High	mRNA High	mRNA High	mRNA High	mRNA High	mRNA High	mRNA High	mRNA High	mRNA High	mRNA High	mRNA High	mRNA High	mRNA Low																																																																																																																																																																																																																																																																																																																																																																																												
SMAD2	MRNA																																	mRNA High																																							mRNA Low																													mRNA High	mRNA High	mRNA High	mRNA High	mRNA High	mRNA High	mRNA High	mRNA High	mRNA High	mRNA High	mRNA High	mRNA High	mRNA High	mRNA Low	mRNA Low	mRNA Low	mRNA Low	mRNA Low	mRNA Low	mRNA Low	mRNA Low	mRNA Low																																																																																																																																																																																																																																																																																																																																																																						
SMAD3	MRNA																					mRNA High																				mRNA Low	mRNA High	mRNA High	mRNA High	mRNA High																	mRNA High																																							mRNA High	mRNA High																					mRNA High	mRNA High	mRNA High	mRNA High	mRNA High	mRNA High	mRNA High	mRNA High	mRNA High	mRNA High	mRNA High	mRNA High	mRNA Low																																																																																																																																																																																																																																																																																																																																																									
SMAD4	MRNA				mRNA Low																																										mRNA High																mRNA High																					mRNA High																															mRNA Low	mRNA Low	mRNA Low	mRNA Low																			mRNA High	mRNA High	mRNA High	mRNA High	mRNA High	mRNA High	mRNA High	mRNA High	mRNA Low	mRNA Low	mRNA Low	mRNA Low	mRNA Low																																																																																																																																																																																																																																																																																																																																												
VIM	MRNA					mRNA High														mRNA High				mRNA High	mRNA High																																							mRNA High														mRNA High							mRNA High																			mRNA High																																														mRNA High	mRNA High	mRNA High	mRNA High	mRNA High	mRNA High	mRNA High	mRNA High	mRNA High	mRNA High																																																																																																																																																																																																																																																																																																																																		
TP53	MRNA					mRNA High	mRNA High	mRNA High	mRNA High												mRNA High					mRNA High																																																mRNA High												mRNA High																				mRNA High													mRNA Low					mRNA High												mRNA High																								mRNA Low		mRNA High	mRNA High	mRNA High	mRNA High	mRNA High	mRNA High	mRNA High	mRNA High	mRNA Low																																																																																																																																																																																																																																																																																																																							
CDH1	MRNA									mRNA Low													mRNA High	mRNA High																								mRNA High																																							mRNA Low															mRNA High				mRNA High	mRNA High								mRNA Low										mRNA High	mRNA High											mRNA High	mRNA High	mRNA High						mRNA High	mRNA High				mRNA Low																					mRNA High	mRNA High	mRNA High	mRNA High	mRNA High	mRNA High	mRNA High	mRNA High	mRNA Low	mRNA Low	mRNA Low																																																																																																																																																																																																																																																																																																												
MAPK3	MRNA																							mRNA High	mRNA High																	mRNA High	mRNA Low																																													mRNA High																		mRNA High										mRNA High	mRNA High			mRNA High							mRNA Low																		mRNA Low					mRNA High	mRNA High	mRNA High																														mRNA High	mRNA High	mRNA High	mRNA High	mRNA High	mRNA Low																																																																																																																																																																																																																																																																																																						
AKT2	MRNA		mRNA High																				mRNA High				mRNA High															mRNA High							mRNA High	mRNA High																																						mRNA High	mRNA High	mRNA High	mRNA High																																					mRNA High									mRNA High	mRNA High								mRNA High																									mRNA High	mRNA High	mRNA High									mRNA High	mRNA High							mRNA High	mRNA High	mRNA High	mRNA High																																																																																																																																																																																																																																																																																																
MIR-203/203A	MRNA																																																																																																																																																																																																																																																																																																																																																																																																																																																																																																
MIR-34/34A	MRNA																																																																																																																																																																																																																																																																																																																																																																																																																																																																																																
SNAI2	MRNA			mRNA High	mRNA High		mRNA High	mRNA High		mRNA High																																																																												mRNA High			mRNA High			mRNA High																																																																																																							mRNA High	mRNA High	mRNA High	mRNA High																																																																																																																																																																																																																																																																																											
TP73	MRNA										mRNA High																										mRNA High																																							mRNA High											mRNA High	mRNA High																																								mRNA High																																																																			mRNA High				mRNA High	mRNA High	mRNA High	mRNA High	mRNA High	mRNA High	mRNA High	mRNA High	mRNA High	mRNA High																																																																																																																																																																																																																																																																																	
AKT1	MRNA								mRNA High																																																																															mRNA High	mRNA High	mRNA High											mRNA High															mRNA High												mRNA High																	mRNA Low		mRNA High			mRNA High	mRNA High		mRNA High																		mRNA High																			mRNA High	mRNA High									mRNA High													mRNA High	mRNA High	mRNA High	mRNA High																																																																																																																																																																																																																																																																									
TP63	MRNA			mRNA High		mRNA High																mRNA High										mRNA High																																										mRNA High												mRNA High							mRNA High																																				mRNA High																																																																		mRNA High						mRNA High																mRNA High	mRNA High	mRNA High	mRNA High	mRNA High	mRNA High	mRNA High																																																																																																																																																																																																																																																																		
ZEB2	MRNA				mRNA High					mRNA High		mRNA High	mRNA High															mRNA High							mRNA High																													mRNA High																				mRNA High		mRNA High	mRNA High					mRNA High		mRNA High	mRNA High																																													mRNA High																							mRNA High																																	mRNA High						mRNA High																						mRNA High	mRNA High	mRNA High	mRNA High	mRNA High	mRNA High	mRNA High	mRNA High																																																																																																																																																																																																																																																										
TGFBR1	MRNA																																											mRNA High	mRNA High			mRNA High			mRNA High	mRNA High										mRNA High			mRNA High	mRNA High	mRNA High																																																																																																																																																																					mRNA High	mRNA High	mRNA High	mRNA High	mRNA High	mRNA High	mRNA High	mRNA High	mRNA High	mRNA High	mRNA High	mRNA High	mRNA High																																																																																																																																																																																																																																													
ZEB1	MRNA				mRNA High					mRNA High				mRNA High									mRNA High					mRNA High					mRNA High																															mRNA High																				mRNA High					mRNA High			mRNA High				mRNA High	mRNA High	mRNA High	mRNA High																																																																																mRNA High	mRNA High												mRNA High																																																					mRNA High	mRNA High	mRNA High																																																																																																																																																																																																																																										
CDKN1A	MRNA											mRNA High			mRNA High							mRNA High			mRNA High			mRNA High																									mRNA High	mRNA High														mRNA High										mRNA High																									mRNA High														mRNA High																															mRNA High																																																													mRNA High	mRNA High																						mRNA High																	mRNA High	mRNA High	mRNA High	mRNA High	mRNA High	mRNA High	mRNA High	mRNA High	mRNA High	mRNA High																																																																																																																																																																																																																															
TWIST1	PROTEIN																																																																																																																																																																																																																																																																																																																																																																																																																																																																																																
SNAI1	PROTEIN																																																																																																																																																																																																																																																																																																																																																																																																																																																																																																
MIR-200A/200A	PROTEIN																																																																																																																																																																																																																																																																																																																																																																																																																																																																																																
DKK1	PROTEIN																																																																																																																																																																																																																																																																																																																																																																																																																																																																																																
CDH2	PROTEIN																																																																																																																																																																																																																																																																																																																																																																																																																																																																																																
CTNNB1	PROTEIN																																																																																																																																																																																																																																																																																																																																																																																																																																																																																																
NOTCH1	PROTEIN																																																																																																																																																																																																																																																																																																																																																																																																																																																																																																
SMAD2	PROTEIN																																																																																																																																																																																																																																																																																																																																																																																																																																																																																																
SMAD3	PROTEIN																																																																																																																																																																																																																																																																																																																																																																																																																																																																																																
SMAD4	PROTEIN																																																																																																																																																																																																																																																																																																																																																																																																																																																																																																
VIM	PROTEIN																																																																																																																																																																																																																																																																																																																																																																																																																																																																																																
TP53	PROTEIN																																																																																																																																																																																																																																																																																																																																																																																																																																																																																																
CDH1	PROTEIN																																																																																																																																																																																																																																																																																																																																																																																																																																																																																																
MAPK3	PROTEIN																																																																																																																																																																																																																																																																																																																																																																																																																																																																																																
AKT2	PROTEIN																																																																																																																																																																																																																																																																																																																																																																																																																																																																																																
MIR-203/203A	PROTEIN																																																																																																																																																																																																																																																																																																																																																																																																																																																																																																
MIR-34/34A	PROTEIN																																																																																																																																																																																																																																																																																																																																																																																																																																																																																																
SNAI2	PROTEIN																																																																																																																																																																																																																																																																																																																																																																																																																																																																																																
TP73	PROTEIN																																																																																																																																																																																																																																																																																																																																																																																																																																																																																																
AKT1	PROTEIN																																																																																																																																																																																																																																																																																																																																																																																																																																																																																																
TP63	PROTEIN																																																																																																																																																																																																																																																																																																																																																																																																																																																																																																
ZEB2	PROTEIN																																																																																																																																																																																																																																																																																																																																																																																																																																																																																																
TGFBR1	PROTEIN																																																																																																																																																																																																																																																																																																																																																																																																																																																																																																
ZEB1	PROTEIN																																																																																																																																																																																																																																																																																																																																																																																																																																																																																																
CDKN1A	PROTEIN																																																																																																																																																																																																																																																																																																																																																																																																																																																																																																
TWIST1	FUSION																																																																																																																																																																																																																																																																																																																																																																																																																																																																																																
SNAI1	FUSION																																																																																																																																																																																																																																																																																																																																																																																																																																																																																																
MIR-200A/200A	FUSION																																																																																																																																																																																																																																																																																																																																																																																																																																																																																																
DKK1	FUSION																																																																																																																																																																																																																																																																																																																																																																																																																																																																																																
CDH2	FUSION																																																																																																																																																																																																																																																																																																																																																																																																																																																																																																
CTNNB1	FUSION																																																																																																																																																																																																																																																																																																																																																																																																																																																																																																
NOTCH1	FUSION																																																																																																																																																																																																																																																																																																																																																																																																																																																																																																
SMAD2	FUSION																																																																																																																																																																																																																																																																																																																																																																																																																																																																																																
SMAD3	FUSION																																																																																																																																																																																																																																																																																																																																																																																																																																																																																																
SMAD4	FUSION																																																																																																																																																																																																																																																																																																																																																																																																																																																																																																
VIM	FUSION																																																																																																																																																																																																																																																																																																																																																																																																																																																																																																
TP53	FUSION																																																																																																																																																																																																																																																																																																																																																																																																																																																																																																
CDH1	FUSION																																																																																																																																																																																																																																																																																																																																																																																																																																																																																																
MAPK3	FUSION																																																																																																																																																																																																																																																																																																																																																																																																																																																																																																
AKT2	FUSION																																																																																																																																																																																																																																																																																																																																																																																																																																																																																																
MIR-203/203A	FUSION																																																																																																																																																																																																																																																																																																																																																																																																																																																																																																
MIR-34/34A	FUSION																																																																																																																																																																																																																																																																																																																																																																																																																																																																																																
SNAI2	FUSION																																																																																																																																																																																																																																																																																																																																																																																																																																																																																																
TP73	FUSION																																																																																																																																																																																																																																																																																																																																																																																																																																																																																																
AKT1	FUSION																																																																																																																																																																																																																																																																																																																																																																																																																																																																																																
TP63	FUSION																																																																																																																																																																																																																																																																																																																																																																																																																																																																																																
ZEB2	FUSION																																																																																																																																																																																																																																																																																																																																																																																																																																																																																																
TGFBR1	FUSION																																																																																																																																																																																																																																																																																																																																																																																																																																																																																																
ZEB1	FUSION																																																																																																																																																																																																																																																																																																																																																																																																																																																																																																
CDKN1A	FUSION																																																																																																																																																																																																																																																																																																																																																																																																																																																																																																
